5 5 5 5 5 5 5 5 5 5 
5 4 4 4 4 4 4 4 4 5 
5 4 3 3 3 3 3 3 4 5 
5 4 3 6 6 6 6 3 4 5 
5 4 3 6 1 1 6 3 4 5 
5 4 3 6 1 1 6 3 4 5 
5 4 3 6 6 6 6 3 4 5 
5 4 3 3 3 3 3 3 4 5 
5 4 4 4 4 4 4 4 4 5 
5 5 5 5 5 5 5 5 5 5 