15 15 15 15 15 15 15 15 15 15 
15 12 12 12 12 12 12 12 12 15 
15 12 6 6 6 6 6 6 12 15 
15 12 6 4 4 4 4 6 12 15 
15 12 6 4 9 9 4 6 12 15 
15 12 6 4 9 9 4 6 12 15 
15 12 6 4 4 4 4 6 12 15 
15 12 6 6 6 6 6 6 12 15 
15 12 12 12 12 12 12 12 12 15 
15 15 15 15 15 15 15 15 15 15 